101010101
000000000
110000100
100001000
110001100
100010001
000000000
000000000
000000010
000000000